Surah Al-Fatihah (الفاتحة - The Opener)
Surah Al-Baqarah (البقرة - The Cow)
Surah Ali 'Imran (آل عمران - Family of Imran)
Surah An-Nisa (النساء - The Women)
Surah Al-Ma'idah (المائدة - The Table Spread)
Surah Al-An'am (الأنعام - The Cattle)
Surah Al-A'raf (الأعراف - The Heights)
Surah Al-Anfal (الأنفال - The Spoils of War)
Surah At-Tawbah (التوبة - The Repentance)
Surah Yunus (يونس - Jonah)
Surah Hud (هود - Hud)
Surah Yusuf (يوسف - Joseph)
Surah Ar-Ra'd (الرعد - The Thunder)
Surah Ibrahim (ابراهيم - Abraham)
Surah Al-Hijr (الحجر - The Rocky Tract)
Surah An-Nahl (النحل - The Bee)
Surah Al-Isra (الإسراء - The Night Journey)
Surah Al-Kahf (الكهف - The Cave)
Surah Maryam (مريم - Mary)
Surah Taha (طه - Ta-Ha)
Surah Al-Anbya (الأنبياء - The Prophets)
Surah Al-Hajj (الحج - The Pilgrimage)
Surah Al-Mu'minun (المؤمنون - The Believers)
Surah An-Nur (النور - The Light)
Surah Al-Furqan (الفرقان - The Criterion)
Surah Ash-Shu'ara (الشعراء - The Poets)
Surah An-Naml (النمل - The Ant)
Surah Al-Qasas (القصص - The Stories)
Surah Al-'Ankabut (العنكبوت - The Spider)
Surah Ar-Rum (الروم - The Romans)
Surah Luqman (لقمان - Luqman)
Surah As-Sajdah (السجدة - The Prostration)
Surah Al-Ahzab (الأحزاب - The Combined Forces)
Surah Saba (سبإ - Sheba)
Surah Fatir (فاطر - Originator)
Surah Ya-Sin (يس - Ya Sin)
Surah As-Saffat (الصافات - Those who set the Ranks)
Surah Sad (ص - The Letter "Saad")
Surah Az-Zumar (الزمر - The Troops)
Surah Ghafir (غافر - The Forgiver)
Surah Fussilat (فصلت - Explained in Detail)
Surah Ash-Shuraa (الشورى - The Consultation)
Surah Az-Zukhruf (الزخرف - The Ornaments of Gold)
Surah Ad-Dukhan (الدخان - The Smoke)
Surah Al-Jathiyah (الجاثية - The Crouching)
Surah Al-Ahqaf (الأحقاف - The Wind-Curved Sandhills)
Surah Muhammad (محمد - Muhammad)
Surah Al-Fath (الفتح - The Victory)
Surah Al-Hujurat (الحجرات - The Rooms)
Surah Qaf (ق - The Letter "Qaf")
Surah Adh-Dhariyat (الذاريات - The Winnowing Winds)
Surah At-Tur (الطور - The Mount)
Surah An-Najm (النجم - The Star)
Surah Al-Qamar (القمر - The Moon)
Surah Ar-Rahman (الرحمن - The Beneficent)
Surah Al-Waqi'ah (الواقعة - The Inevitable)
Surah Al-Hadid (الحديد - The Iron)
Surah Al-Mujadila (المجادلة - The Pleading Woman)
Surah Al-Hashr (الحشر - The Exile)
Surah Al-Mumtahanah (الممتحنة - She that is to be examined)
Surah As-Saf (الصف - The Ranks)
Surah Al-Jumu'ah (الجمعة - The Congregation, Friday)
Surah Al-Munafiqun (المنافقون - The Hypocrites)
Surah At-Taghabun (التغابن - The Mutual Disillusion)
Surah At-Talaq (الطلاق - The Divorce)
Surah At-Tahrim (التحريم - The Prohibition)
Surah Al-Mulk (الملك - The Sovereignty)
Surah Al-Qalam (القلم - The Pen)
Surah Al-Haqqah (الحاقة - The Reality)
Surah Al-Ma'arij (المعارج - The Ascending Stairways)
Surah Nuh (نوح - Noah)
Surah Al-Jinn (الجن - The Jinn)
Surah Al-Muzzammil (المزمل - The Enshrouded One)
Surah Al-Muddaththir (المدثر - The Cloaked One)
Surah Al-Qiyamah (القيامة - The Resurrection)
Surah Al-Insan (الانسان - The Man)
Surah Al-Mursalat (المرسلات - The Emissaries)
Surah An-Naba (النبإ - The Tidings)
Surah An-Nazi'at (النازعات - Those who drag forth)
Surah 'Abasa (عبس - He Frowned)
Surah At-Takwir (التكوير - The Overthrowing)
Surah Al-Infitar (الإنفطار - The Cleaving)
Surah Al-Mutaffifin (المطففين - The Defrauding)
Surah Al-Inshiqaq (الإنشقاق - The Sundering)
Surah Al-Buruj (البروج - The Mansions of the Stars)
Surah At-Tariq (الطارق - The Nightcommer)
Surah Al-A'la (الأعلى - The Most High)
Surah Al-Ghashiyah (الغاشية - The Overwhelming)
Surah Al-Fajr (الفجر - The Dawn)
Surah Al-Balad (البلد - The City)
Surah Ash-Shams (الشمس - The Sun)
Surah Al-Layl (الليل - The Night)
Surah Ad-Duhaa (الضحى - The Morning Hours)
Surah Ash-Sharh (الشرح - The Relief)
Surah At-Tin (التين - The Fig)
Surah Al-'Alaq (العلق - The Clot)
Surah Al-Qadr (القدر - The Power)
Surah Al-Bayyinah (البينة - The Clear Proof)
Surah Az-Zalzalah (الزلزلة - The Earthquake)
Surah Al-'Adiyat (العاديات - The Courser)
Surah Al-Qari'ah (القارعة - The Calamity)
Surah At-Takathur (التكاثر - The Rivalry in world increase)
Surah Al-'Asr (العصر - The Declining Day)
Surah Al-Humazah (الهمزة - The Traducer)
Surah Al-Fil (الفيل - The Elephant)
Surah Quraysh (قريش - Quraysh)
Surah Al-Ma'un (الماعون - The Small kindnesses)
Surah Al-Kawthar (الكوثر - The Abundance)
Surah Al-Kafirun (الكافرون - The Disbelievers)
Surah An-Nasr (النصر - The Divine Support)
Surah Al-Masad (المسد - The Palm Fiber)
Surah Al-Ikhlas (الإخلاص - The Sincerity)
Surah Al-Falaq (الفلق - The Daybreak)
Surah An-Nas (الناس - Mankind)
